{{Stub}}

=List of Terms in Alphabetical Order=

==A==
* afeminado: effeminate 
* agénero: [[agender]]
* aliado: ally
* androginia: androgyny
* andrógino/andrógina: [[androgyne]]
* apariencia andrógina: androgynous look
* asignado hombre al nacer (AHAN): [[AMAB]], DMAB, CAMAB, MAAB
* asignado mujer al nacer (AMAN): [[AFAB]], DFAB, CAFAB, FAAB 

==B==
* bigénero: [[bigender]]

==C==
* cambio de nombre: name change
* cisgénero: [[cisgender]]
* cissexismo: cissexism 
* cisheteronormativo: cisheteronormative

==D==
* disforia de género: [[gender dysphoria]]
* dos espíritus: [[two-spirit]]

==E==
* eunuco: eunuch
* espectro de género: gender spectrum 
* estereotipos de género: gender stereotypes 
* estudios de género‎: gender studies
* expresión de género: [[gender expression]] 

==F==
* femenino: feminine 
* femme: femme 
* feminidad: femininity
* feminismo transexclusivista: TERF

==G==
* género: gender
* género fluido: [[genderfluid]]
* género neutro: [[gender neutral]]
* género queer: [[genderqueer]]
* géneros binarios: [[gender binary]]

==H==
* heteronormativo: heteronormative 

==I==
* intersexualidad: [[intersex | intersexuality]]
* intergénero: [[intergender]] 
* identidad de género: [[gender identity]] 
* identidad personal: self-identity 
* identidades no-binarias: [[non-binary identities]]

==K==
* kuir: [[queer]]

==M==
* marimacho (pejorative, can be used as an insult): butch; tomboy
* machorra (pejorative, can be used as an insult): butch, tomboy 
* maricón (pejorative): sissy
* masculinidad: masculinity
* masculino: masculine 
* multigénero: [[multigender]] / [[pangender]]

==N==
* no-binario: [[non-binary]]

==P==
* pangénero: [[pangender]]
* pareja: partner (can be used for neutral term for significant other)

==R==
* roles de género: [[gender role|gender roles]]

==S==
* salir del armario: [[coming out]] (of the closet)
* semichica/semimujer: [[demigirl]]
* semichico/semihombre: [[demiboy]] 
* sexo asignado al nacimiento: [[sex|assigned sex at birth]]
* sexo biológico: [[sex|biological sex]] 

==T==
* travesti: transvestite, [[transgender]]; a gender identity in some Latin American countries
* travestismo: travestism 
* teoría queer: queer theory
* teoría de género: gender theory
* tercer sexo: third sex
* transgénero: [[transgender]]
* trigénero: trigender
* transfobia: transphobia
* tránsfobo/tránsfoba: transphobe 
* transfóbico/transfóbica: transphobic
* transmisoginia: transmisogyny
* transmisógino/transmisógina: transmisoginist
* transición: transition (noun)
* transicionar: transition (verb)
* transgresión de género: gender transgression 
* transexclusión/transexcluyente: TERF

=External Links=
* [http://nobinario.tumblr.com/ Género Queer y No-binario]

[[Category:Practical resources]] [[Category:Language]]
